##########
# @      #
# ###### #
# #      #
# # #### #
# # #    #
# # # ####
#   #    #
#####X####