####################
#S#                #
# # ########### ## #
# # #E        # #X #
# # # ######### # ##
# # # #         #  #
# ### # ####### #  #
#   # # #  #E  # #  #
### # # #  #  # #  #
#   # # #  #  # #  #
# ### # #  #  # #  #
# #   # #  #  # #  #
# # ### ###  # #  #
# # #  E#    # #  #
# # #  # ##### #  #
#   #  #       #  #
#####E#########  #
#                #
##################