####################
#P.................#
#.#.########.#######
#.#.#......#.#.....#
#.#.#.####.#.#.###.#
#...#.#..#.#...#...#
#####.#.#.#.#####.#
#...#.#.#.#.#.....#
#.#.#.#.#.#.#.#####
#.#...#...#.#.....#
####################
